NO ./textures/wall/NO_0.png
SO ./textures/wall/SO_0.png
WE ./textures/wall/WE_0.png
EA ./textures/wall/EA_0.png
F 196,74,65
C 68,133,173
1111111111111111111111
1100100001000010000011
1000000000000000000001
1000000000000000000001
1000000000000000000001
1000000000000000000001
1000000000S00000000001
1000000000000000000001
1000000000000000000001
1000000000011111000000111
100000000001   100000000011
110010000101   100010000011
111111111111   111111111111