NO ./textures/wall/NO_0.png
SO ./textures/wall/SO_0.png
WE ./textures/wall/WE_0.png
EA ./textures/wall/EA_0.png
F 220,100,0
C 225,30,0
1111111111
1000000101
100000000011111
1000000000000N1
100000111111111
1000001
1000001
100000011111
1000000000001
1111111111111